' др. '	' др. '	другой
' пр. '	' пр. '	прочий
а - ля	а - ль	а - ля
а - форфе	а - форф	а - форфе
а не то	а не тый	а не то
а то	а тый	а то
аава	аава	аав
аавам	аава	аав
аавами	аава	аав
аавах	аава	аав
ааве	аава	аав
аавов	аавов	аав
ааву	аава	аав
аавы	аава	аав
аака	аака	аак
ааками	ааками	аак
ааках	аакаха	аак
ааке	аака	аак
ааки	ааки	аак
ааков	ааковы	аак
ааком	ааком	аак
ааку	аака	аак
ааленца	ааленца	ааленец
ааленце	ааленца	ааленец
ааленцем	ааленц	ааленец
ааленцу	ааленца	ааленец
ааленцы	ааленца	ааленец
аант	аант	аанта
аанта	аант	аанта
аантам	аант	аанта
аантами	аант	аанта
аантах	аант	аанта
аанте	аант	аанта
аантой	аантой	аанта
аантою	аантой	аанта
аанту	аант	аанта
аанты	аант	аанта
аароновец	аароновца	аароновец
аароновца	аароновца	аароновец
аароновцам	аароновца	аароновец
аароновцами	аароновца	аароновец
аароновцах	аароновца	аароновец
аароновце	аароновца	аароновец
аароновцу	аароновца	аароновец
аароновцы	аароновца	аароновец
аахенами	аахенами	аахен
аахене	аахена	аахен
аахенов	аахеновый	аахен
аахеном	аахеном	аахен
абаасам	абаасам	абаас
абаасу	абаасу	абаас
Абабкова	абабков	Абабкова
Абабковой	абабков	Абабкова
Абабкову	абабков	Абабкова
абаз	абаз	абаза
абаза	абаз	абаза
абазам	абаз	абаза
абазами	абаз	абаза
абазах	абаз	абаза
абазе	абаз	абаза
абазу	абаз	абаза
абазы	абаз	абаза
абаимам	абаимам	абаим
абаимами	абаимами	абаим
абаимах	абаимах	абаим
абаимов	абаимов	абаим
абайцами	абайцами	абаец
абак	абак	абака
абака	абака	абак
абакам	абак	абака
абаками	абак	абака
абаках	абак	абака
абаке	абак	абака
абаки	абака	абак
абакост	абакоста	абакост
абакоста	абакоста	абакост
абакостам	абакоста	абакост
абакостами	абакоста	абакост
абакостах	абакоста	абакост
абакосте	абакоста	абакост
абакостов	абакостов	абакост
абакосту	абакоста	абакост
абакосты	абакоста	абакост
абактериальнейшего	абактериальнейший	абактериальный
абактериальнейшему	абактериальнейший	абактериальный
абактериальнейшими	абактериальнейший	абактериальный
абаку	абак	абака
Абакумов	абакум	Абакумов
Абакумова	абакумов	Абакумова
Абакумовна	абакумович	Абакумовна
Абакумовне	абакумович	Абакумовна
Абакумовной	абакумович	Абакумовна
Абакумовною	абакумовный	Абакумовна
Абакумовну	абакумович	Абакумовна
Абакумовны	абакумович	Абакумовна
Абакумовой	абакумов	Абакумова
Абакумову	абакумов	Абакумова
Абалихина	абалихин	Абалихина
Абалихиной	абалихин	Абалихина
Абалихину	абалихин	Абалихина
Абалышева	абалышев	Абалышева
Абалышевой	абалышев	Абалышева
Абалышеву	абалышев	Абалышева
абанцами	абанцами	абанец
Абарников	абарниковый	Абарников
Абарникова	абарниковый	Абарников
Абарникова	абарниковый	Абарникова
Абарниковой	абарниковый	Абарникова
Абарникову	абарников	Абарникова
Абарниковы	абарниковый	Абарников
Абарниковым	абарниковый	Абарников
Абарниковыми	абарниковый	Абарников
Абарниковых	абарниковый	Абарников
абатуров	абатуров	абатур
абатцами	абатцами	абатец
абатчан	абатчан	абатчанин
абатчанам	абатчан	абатчанин
абатчанами	абатчан	абатчанин
абатчанах	абатчан	абатчанин
абатчане	абатчан	абатчанин
абатчанка	абатчанк	абатчанка
абатчанкам	абатчанк	абатчанка
абатчанками	абатчанк	абатчанка
абатчанках	абатчанк	абатчанка
абатчанке	абатчанк	абатчанка
абатчанки	абатчанк	абатчанка
абатчанку	абатчанк	абатчанка
абациста	абациста	абацист
абацистам	абациста	абацист
абацистами	абациста	абацист
абацистах	абациста	абацист
абацисте	абациста	абацист
абацистов	абацистовый	абацист
абацистом	абацистома	абацист
абацисту	абациста	абацист
абацисты	абациста	абацист
абашская	абашскай	абашский
абашским	абашским	абашский
абашском	абашскома	абашский
абашскому	абашскома	абашский
абашскую	абашсковать	абашский
абашцами	абашцами	абашец
аббасид	аббасида	аббасид
аббасида	аббасида	аббасид
аббасидам	аббасида	аббасид
аббасидами	аббасида	аббасид
аббасидах	аббасида	аббасид
аббасиде	аббасида	аббасид
аббасиду	аббасида	аббасид
аббасиды	аббасида	аббасид
абверовец	абверовца	абверовец
абверовца	абверовца	абверовец
абверовцам	абверовца	абверовец
абверовцами	абверовца	абверовец
абверовцах	абверовца	абверовец
абверовце	абверовца	абверовец
абверовцу	абверовца	абверовец
абверовцы	абверовца	абверовец
абгаза	абгаза	абгаз
абгазе	абгаза	абгаз
абгазу	абгаза	абгаз
абгазы	абгаза	абгаз
абджада	абджада	абджад
абджадам	абджадам	абджад
абджадами	абджада	абджад
абджадах	абджада	абджад
абджаде	абджада	абджад
абджадов	абджадов	абджад
абджаду	абджаду	абджад
абджады	абджады	абджад
абдоминопластиками	абдоминопластик	абдоминопластика
абду - салам	абду - сало	абду - салам
абдуктанта	абдуктанта	абдуктант
абдуктанте	абдуктанта	абдуктант
абдуктанту	абдуктанта	абдуктант
абдуктанты	абдуктанта	абдуктант
абдул - азизами	абдул - азизами	абдул - азиз
абдулинца	абдулинц	абдулинец
абдулинце	абдулинц	абдулинец
абдулинцем	абдулинц	абдулинец
абдулинцу	абдулинц	абдулинец
Абдулла	абдулл	Абдулла
Абдулле	абдулл	Абдулла
Абдуллу	абдулл	Абдулла
Абдулов	абдул	Абдулов
Абдулова	абдулов	Абдулова
Абдуловой	абдулов	Абдулова
Абдулову	абдулов	Абдулова
абдульчерим	абдульчерить	абдульчерим
абевег	абевег	абевега
абевегам	абевегам	абевега
абевегами	абевег	абевега
абевегах	абевег	абевега
абеле	абел	абель
абелевого	абелевый	абелев
абелевому	абелевый	абелев
абелевская	абелёвский	абелевский
абелевские	абелёвский	абелевский
абелевский	абелёвский	абелевский
абелевским	абелёвский	абелевский
абелевскими	абелёвский	абелевский
абелевских	абелёвский	абелевский
абелевского	абелёвский	абелевский
абелевское	абелёвский	абелевский
абелевской	абелёвский	абелевский
абелевском	абелёвский	абелевский
абелевскому	абелёвский	абелевский
абелевскою	абелёвский	абелевский
абелевскую	абелёвский	абелевский
абели	абели	абель
абердин - ангуса	абердин - ангуса	абердин - ангус
абердин - ангусам	абердин - ангусама	абердин - ангус
абердин - ангусе	абердин - ангусь	абердин - ангус
абердин - ангусов	абердин - ангусов	абердин - ангус
абердин - ангусу	абердин - ангуса	абердин - ангус
абердин - ангусы	абердин - ангуса	абердин - ангус
абердинская	абердинской	абердинский
абердинские	абердинской	абердинский
абердинским	абердинской	абердинский
абердинскими	абердинской	абердинский
абердинских	абердинской	абердинский
абердинского	абердинской	абердинский
абердинское	абердинской	абердинский
абердинской	абердинской	абердинский
абердинском	абердинской	абердинский
абердинскому	абердинской	абердинский
абердинскою	абердинской	абердинский
абердинскую	абердинской	абердинский
абернатит	абернатить	абернатит
абернатите	абернатить	абернатит
аберрирован	аберрировать	аберрированный
аберрирована	аберрировать	аберрированный
аберрированная	аберрировать	аберрированный
аберрированное	аберрировать	аберрированный
аберрированной	аберрировать	аберрированный
аберрированном	аберрировать	аберрированный
аберрированною	аберрировать	аберрированный
аберрированную	аберрировать	аберрированный
аберрированные	аберрировать	аберрированный
аберрированный	аберрировать	аберрированный
аберрированным	аберрировать	аберрированный
аберрированных	аберрировать	аберрированный
аберрировано	аберрировать	аберрированный
аберрированы	аберрировать	аберрированный
аберрирующая	аберрировать	аберрирующий
аберрирующего	аберрируть	аберрирующий
аберрирующее	аберрировать	аберрирующий
аберрирующей	аберрировать	аберрирующий
аберрирующем	аберрировать	аберрирующий
аберрирующему	аберрируть	аберрирующий
аберрирующею	аберрировать	аберрирующий
аберрирующие	аберрировать	аберрирующий
аберрирующий	аберрировать	аберрирующий
аберрирующим	аберрировать	аберрирующий
аберрирующими	аберрируть	аберрирующий
аберрирующих	аберрировать	аберрирующий
аберрирующую	аберрировать	аберрирующий
аберрируя	аберрировать	аберрируя
абессив	абессивый	абессив
абессива	абессивый	абессив
абессиве	абессива	абессив
абессивов	абессивов	абессив
абессивом	абессивый	абессив
абессиву	абессива	абессив
абессивы	абессивый	абессив
абзелил	абзелила	абзелил
абзелила	абзелила	абзелил
абзелилам	абзелила	абзелил
абзелилами	абзелила	абзелил
абзелилах	абзелила	абзелил
абзелиле	абзелила	абзелил
абзелилов	абзелиловый	абзелил
абзелилу	абзелила	абзелил
абзелилы	абзелила	абзелил
абиле	абил	абиль
абинка	абинк	абинка
абинкам	абинк	абинка
абинками	абинк	абинка
абинках	абинк	абинка
абинке	абинк	абинка
абинки	абинк	абинка
абинку	абинк	абинка
абинное	абинной	абинный
абинной	абинна	абинный
абинном	абинном	абинный
абинному	абинном	абинный
абинною	абинна	абинный
абинок	абинок	абинка
Абинском	абинский	Абинск
абинцами	абинцами	абинец
абинчан	абинчан	абинчанин
абинчанам	абинчан	абинчанин
абинчанами	абинчан	абинчанин
абинчанах	абинчан	абинчанин
абинчане	абинчан	абинчанин
абиогенно	абиогенный	абиогенно
абисалом	абисалом	абисал
абиссолит	абиссолить	абиссолит
абиссолите	абиссолить	абиссолит
абитур	абитура	абитур
абитура	абитура	абитур
абитурам	абитура	абитур
абитурами	абитура	абитур
абитурах	абитура	абитур
абитуре	абитура	абитур
абитурной	абитурна	абитурный
абитурною	абитурна	абитурный
абитуру	абитура	абитур
абитуры	абитура	абитур
аблации	аблации	аблация
Абоимова	абоимов	Абоимова
Абоимовой	абоимов	Абоимова
Абоимову	абоимов	Абоимова
Абоймов	абойм	Абоймов
Абоймова	абоймов	Абоймова
Абоймовой	абоймов	Абоймова
Абоймову	абоймов	Абоймова
абонировав	абонировать	абонировав
абонировавшая	абонировать	абонировавший
абонировавшего	абонировать	абонировавший
абонировавшее	абонировать	абонировавший
абонировавшей	абонировать	абонировавший
абонировавшем	абонировать	абонировавший
абонировавшему	абонировать	абонировавший
абонировавшею	абонировать	абонировавший
абонировавшие	абонировать	абонировавший
абонировавший	абонировать	абонировавший
абонировавшим	абонировать	абонировавший
абонировавшими	абонировать	абонировавший
абонировавших	абонировать	абонировавший
абонировавшую	абонировать	абонировавший
абонирован	абонировать	абонированный
абонирована	абонировать	абонированный
абонированная	абонировать	абонированный
абонированного	абонировать	абонированный
абонированное	абонировать	абонированный
абонированной	абонировать	абонированный
абонированном	абонировать	абонированный
абонированному	абонировать	абонированный
абонированною	абонировать	абонированный
абонированную	абонировать	абонированный
абонированные	абонировать	абонированный
абонированный	абонировать	абонированный
абонированным	абонировать	абонированный
абонированными	абонировать	абонированный
абонированных	абонировать	абонированный
абонировано	абонировать	абонированный
абонированы	абонировать	абонированный
абонируя	абонировать	абонируя
абонируясь	абонироваться	абонируясь
абонплат	абонплат	абонплата
абонплата	абонплат	абонплата
абонплатам	абонплат	абонплата
абонплатами	абонплат	абонплата
абонплатах	абонплат	абонплата
абонплате	абонплат	абонплата
абонплату	абонплат	абонплата
абонплаты	абонплат	абонплата
вишерцы	вишерцы	вишерец
вишневая	вишнёвый	вишневый
вишневенькой	вишневенька	вишневенький
вишневенькою	вишневенька	вишневенький
вишневка	вишнёвка	вишневка
вишневкам	вишнёвка	вишневка
вишневками	вишнёвка	вишневка
вишневках	вишнёвка	вишневка
вишневке	вишнёвка	вишневка
вишневки	вишнёвка	вишневка
вишневкой	вишнёвка	вишневка
вишневкою	вишнёвка	вишневка
вишневку	вишнёвка	вишневка
вишнево	вишнёвый	вишнево
вишневого	вишнёвый	вишневый
вишневое	вишнёвый	вишневый
вишневой	вишнёвый	вишневый
вишневок	вишнёвка	вишневка
вишневом	вишнёвый	вишневый
вишневому	вишнёвый	вишневый
вишневою	вишнёвый	вишневый
вишневую	вишнёвый	вишневый
вишневые	вишнёвый	вишневый
вишневый	вишнёвый	вишневый
вишневым	вишнёвый	вишневый
вишневыми	вишнёвый	вишневый
вишневых	вишнёвый	вишневый
Вишняков	вишняк	Вишняков
Вишнякова	вишняков	Вишнякова
Вишняковой	вишняков	Вишнякова
Вишнякову	вишняков	Вишнякова
вкалывавшая	вкалывать	вкалывавший
вкалывавшаяся	вкалываться	вкалывавшийся
вкалывавшего	вкалывать	вкалывавший
вкалывавшегося	вкалываться	вкалывавшийся
вкалывавшее	вкалывать	вкалывавший
вкалывавшееся	вкалываться	вкалывавшийся
вкалывавшей	вкалывать	вкалывавший
вкалывавшейся	вкалываться	вкалывавшийся
вкалывавшем	вкалывать	вкалывавший
вкалывавшемся	вкалываться	вкалывавшийся
вкалывавшему	вкалывать	вкалывавший
вкалывавшемуся	вкалываться	вкалывавшийся
вкалывавшею	вкалывать	вкалывавший
вкалывавшеюся	вкалываться	вкалывавшийся
вкалывавшие	вкалывать	вкалывавший
вкалывавшиеся	вкалываться	вкалывавшийся
вкалывавший	вкалывать	вкалывавший
вкалывавшийся	вкалываться	вкалывавшийся
вкалывавшим	вкалывать	вкалывавший
вкалывавшими	вкалывать	вкалывавший
вкалывавшимися	вкалываться	вкалывавшийся
вкалывавшимся	вкалываться	вкалывавшийся
вкалывавших	вкалывать	вкалывавший
вкалывавшихся	вкалываться	вкалывавшийся
вкалывавшую	вкалывать	вкалывавший
вкалывавшуюся	вкалываться	вкалывавшийся
вкалывании	вкалывания	вкалывание
вкалыванию	вкалывания	вкалывание
вкалывания	вкалывания	вкалывание
вкалывающая	вкалывать	вкалывающий
вкалывающаяся	вкалываться	вкалывающийся
вкалывающего	вкалывать	вкалывающий
вкалывающегося	вкалываться	вкалывающийся
вкалывающее	вкалывать	вкалывающий
вкалывающееся	вкалываться	вкалывающийся
вкалывающей	вкалывать	вкалывающий
вкалывающейся	вкалываться	вкалывающийся
вкалывающем	вкалывать	вкалывающий
вкалывающемся	вкалываться	вкалывающийся
вкалывающему	вкалывать	вкалывающий
вкалывающемуся	вкалываться	вкалывающийся
вкалывающею	вкалывать	вкалывающий
вкалывающеюся	вкалываться	вкалывающийся
вкалывающие	вкалывать	вкалывающий
вкалывающиеся	вкалываться	вкалывающийся
вкалывающий	вкалывать	вкалывающий
вкалывающийся	вкалываться	вкалывающийся
вкалывающим	вкалывать	вкалывающий
вкалывающими	вкалывать	вкалывающий
вкалывающимися	вкалываться	вкалывающийся
вкалывающимся	вкалываться	вкалывающийся
вкалывающих	вкалывать	вкалывающий
вкалывающихся	вкалываться	вкалывающийся
вкалывающую	вкалывать	вкалывающий
вкалывающуюся	вкалываться	вкалывающийся
вкалывая	вкалывать	вкалывая
вкалываясь	вкалываться	вкалываясь
вкапывавшаяся	вкапываться	вкапывавшийся
вкапывавшегося	вкапываться	вкапывавшийся
вкапывавшееся	вкапываться	вкапывавшийся
вкапывавшейся	вкапываться	вкапывавшийся
вкапывавшемся	вкапываться	вкапывавшийся
вкапывавшемуся	вкапываться	вкапывавшийся
вкапывавшеюся	вкапываться	вкапывавшийся
вкапывавшиеся	вкапываться	вкапывавшийся
вкапывавшийся	вкапываться	вкапывавшийся
вкапывавшимися	вкапываться	вкапывавшийся
вкапывавшимся	вкапываться	вкапывавшийся
вкапывавшихся	вкапываться	вкапывавшийся
вкапывавшуюся	вкапываться	вкапывавшийся
вкапываемая	вкапывать	вкапываемый
вкапываемого	вкапывать	вкапываемый
вкапываемое	вкапывать	вкапываемый
вкапываемой	вкапывать	вкапываемый
вкапываемом	вкапывать	вкапываемый
вкапываемому	вкапывать	вкапываемый
вкапываемою	вкапывать	вкапываемый
вкапываемую	вкапывать	вкапываемый
вкапываемые	вкапывать	вкапываемый
вкапываемый	вкапывать	вкапываемый
вкапываемым	вкапывать	вкапываемый
вкапываемыми	вкапывать	вкапываемый
вкапываемых	вкапывать	вкапываемый
вкапывающая	вкапывать	вкапывающий
вкапывающаяся	вкапываться	вкапывающийся
вкапывающего	вкапывать	вкапывающий
вкапывающегося	вкапываться	вкапывающийся
вкапывающее	вкапывать	вкапывающий
вкапывающееся	вкапываться	вкапывающийся
вкапывающей	вкапывать	вкапывающий
вкапывающейся	вкапываться	вкапывающийся
вкапывающем	вкапывать	вкапывающий
вкапывающемся	вкапываться	вкапывающийся
вкапывающему	вкапывать	вкапывающий
вкапывающемуся	вкапываться	вкапывающийся
вкапывающею	вкапывать	вкапывающий
вкапывающеюся	вкапываться	вкапывающийся
вкапывающие	вкапывать	вкапывающий
вкапывающиеся	вкапываться	вкапывающийся
вкапывающий	вкапывать	вкапывающий
вкапывающийся	вкапываться	вкапывающийся
вкапывающим	вкапывать	вкапывающий
вкапывающими	вкапывать	вкапывающий
вкапывающимися	вкапываться	вкапывающийся
вкапывающимся	вкапываться	вкапывающийся
вкапывающих	вкапывать	вкапывающий
вкапывающихся	вкапываться	вкапывающийся
вкапывающую	вкапывать	вкапывающий
вкапывающуюся	вкапываться	вкапывающийся
вкапывая	вкапывать	вкапывая
вкапываясь	вкапываться	вкапываясь
вкарабкавшись	вкарабкаться	вкарабкавшись
вкарабкиваясь	вкарабкиваться	вкарабкиваясь
вкатав	вкатать	вкатав
вкатив	вкатить	вкатив
вкатившая	вкатить	вкативший
вкатившаяся	вкатиться	вкатившийся
вкатившего	вкатить	вкативший
вкатившегося	вкатиться	вкатившийся
вкатившее	вкатить	вкативший
вкатившееся	вкатиться	вкатившийся
вкатившей	вкатить	вкативший
вкатившейся	вкатиться	вкатившийся
вкатившем	вкатить	вкативший
вкатившемся	вкатиться	вкатившийся
вкатившему	вкатить	вкативший
вкатившемуся	вкатиться	вкатившийся
вкатившею	вкатить	вкативший
вкатившеюся	вкатиться	вкатившийся
вкатившие	вкатить	вкативший
вкатившиеся	вкатиться	вкатившийся
вкативший	вкатить	вкативший
вкатившийся	вкатиться	вкатившийся
вкатившим	вкатить	вкативший
вкатившими	вкатить	вкативший
вкатившимися	вкатиться	вкатившийся
вкатившимся	вкатиться	вкатившийся
вкатившись	вкатиться	вкатившись
вкативших	вкатить	вкативший
вкатившихся	вкатиться	вкатившийся
вкатившую	вкатить	вкативший
вкатившуюся	вкатиться	вкатившийся
вкатывавшая	вкатывать	вкатывавший
вкатывавшаяся	вкатываться	вкатывавшийся
вкатывавшего	вкатывать	вкатывавший
вкатывавшегося	вкатываться	вкатывавшийся
вкатывавшее	вкатывать	вкатывавший
вкатывавшееся	вкатываться	вкатывавшийся
вкатывавшей	вкатывать	вкатывавший
вкатывавшейся	вкатываться	вкатывавшийся
вкатывавшем	вкатывать	вкатывавший
вкатывавшемся	вкатываться	вкатывавшийся
вкатывавшему	вкатывать	вкатывавший
вкатывавшемуся	вкатываться	вкатывавшийся
вкатывавшею	вкатывать	вкатывавший
вкатывавшеюся	вкатываться	вкатывавшийся
вкатывавшие	вкатывать	вкатывавший
вкатывавшиеся	вкатываться	вкатывавшийся
вкатывавший	вкатывать	вкатывавший
вкатывавшийся	вкатываться	вкатывавшийся
вкатывавшим	вкатывать	вкатывавший
вкатывавшими	вкатывать	вкатывавший
вкатывавшимися	вкатываться	вкатывавшийся
вкатывавшимся	вкатываться	вкатывавшийся
вкатывавших	вкатывать	вкатывавший
вкатывавшихся	вкатываться	вкатывавшийся
вкатывавшую	вкатывать	вкатывавший
вкатывавшуюся	вкатываться	вкатывавшийся
вкатывании	вкатывания	вкатывание
вкатыванию	вкатывания	вкатывание
вкатывания	вкатывания	вкатывание
вкатывающая	вкатывать	вкатывающий
вкатывающаяся	вкатываться	вкатывающийся
вкатывающего	вкатывать	вкатывающий
вкатывающегося	вкатываться	вкатывающийся
вкатывающее	вкатывать	вкатывающий
вкатывающееся	вкатываться	вкатывающийся
вкатывающей	вкатывать	вкатывающий
вкатывающейся	вкатываться	вкатывающийся
вкатывающем	вкатывать	вкатывающий
вкатывающемся	вкатываться	вкатывающийся
вкатывающему	вкатывать	вкатывающий
вкатывающемуся	вкатываться	вкатывающийся
вкатывающею	вкатывать	вкатывающий
вкатывающеюся	вкатываться	вкатывающийся
вкатывающие	вкатывать	вкатывающий
вкатывающиеся	вкатываться	вкатывающийся
вкатывающий	вкатывать	вкатывающий
вкатывающийся	вкатываться	вкатывающийся
вкатывающим	вкатывать	вкатывающий
вкатывающими	вкатывать	вкатывающий
вкатывающимися	вкатываться	вкатывающийся
вкатывающимся	вкатываться	вкатывающийся
вкатывающих	вкатывать	вкатывающий
вкатывающихся	вкатываться	вкатывающийся
вкатывающую	вкатывать	вкатывающий
вкатывающуюся	вкатываться	вкатывающийся
вкатывая	вкатывать	вкатывая
вкатываясь	вкатываться	вкатываясь
вкачав	вкачать	вкачав
вкачавшая	вкачать	вкачавший
вкачавшего	вкачать	вкачавший
вкачавшее	вкачать	вкачавший
вкачавшей	вкачать	вкачавший
вкачавшем	вкачать	вкачавший
вкачавшему	вкачать	вкачавший
вкачавшею	вкачать	вкачавший
вкачавшие	вкачать	вкачавший
вкачавший	вкачать	вкачавший
вкачавшим	вкачать	вкачавший
вкачавшими	вкачать	вкачавший
вкачавших	вкачать	вкачавший
вкачавшую	вкачать	вкачавший
вкачан	вкачать	вкачанный
вкачана	вкачать	вкачанный
вкачанная	вкачать	вкачанный
вкачанного	вкачать	вкачанный
вкачанное	вкачать	вкачанный
вкачанной	вкачать	вкачанный
вкачанном	вкачать	вкачанный
вкачанному	вкачать	вкачанный
вкачанною	вкачать	вкачанный
вкачанную	вкачать	вкачанный
вкачанные	вкачать	вкачанный
вкачанный	вкачать	вкачанный
вкачанным	вкачать	вкачанный
вкачанными	вкачать	вкачанный
вкачанных	вкачать	вкачанный
вкачано	вкачать	вкачанный
вкачаны	вкачать	вкачанный
вкачивавшая	вкачивать	вкачивавший
вкачивавшаяся	вкачиваться	вкачивавшийся
вкачивавшего	вкачивать	вкачивавший
вкачивавшегося	вкачиваться	вкачивавшийся
вкачивавшее	вкачивать	вкачивавший
вкачивавшееся	вкачиваться	вкачивавшийся
вкачивавшей	вкачивать	вкачивавший
вкачивавшейся	вкачиваться	вкачивавшийся
вкачивавшем	вкачивать	вкачивавший
вкачивавшемся	вкачиваться	вкачивавшийся
вкачивавшему	вкачивать	вкачивавший
вкачивавшемуся	вкачиваться	вкачивавшийся
вкачивавшею	вкачивать	вкачивавший
вкачивавшеюся	вкачиваться	вкачивавшийся
вкачивавшие	вкачивать	вкачивавший
вкачивавшиеся	вкачиваться	вкачивавшийся
вкачивавший	вкачивать	вкачивавший
вкачивавшийся	вкачиваться	вкачивавшийся
вкачивавшим	вкачивать	вкачивавший
вкачивавшими	вкачивать	вкачивавший
вкачивавшимися	вкачиваться	вкачивавшийся
вкачивавшимся	вкачиваться	вкачивавшийся
вкачивавших	вкачивать	вкачивавший
вкачивавшихся	вкачиваться	вкачивавшийся
вкачивавшую	вкачивать	вкачивавший
вкачивавшуюся	вкачиваться	вкачивавшийся
вкачивании	вкачивания	вкачивание
вкачиваний	вкачивания	вкачивание
вкачиванию	вкачивания	вкачивание
вкачивания	вкачивания	вкачивание
вкачиваниям	вкачивания	вкачивание
вкачиваниями	вкачивания	вкачивание
вкачиваниях	вкачивания	вкачивание
вкачивающая	вкачивать	вкачивающий
вкачивающаяся	вкачиваться	вкачивающийся
вкачивающего	вкачивать	вкачивающий
вкачивающегося	вкачиваться	вкачивающийся
вкачивающее	вкачивать	вкачивающий
вкачивающееся	вкачиваться	вкачивающийся
вкачивающей	вкачивать	вкачивающий
вкачивающейся	вкачиваться	вкачивающийся
вкачивающем	вкачивать	вкачивающий
вкачивающемся	вкачиваться	вкачивающийся
вкачивающему	вкачивать	вкачивающий
вкачивающемуся	вкачиваться	вкачивающийся
вкачивающею	вкачивать	вкачивающий
вкачивающеюся	вкачиваться	вкачивающийся
вкачивающие	вкачивать	вкачивающий
вкачивающиеся	вкачиваться	вкачивающийся
вкачивающий	вкачивать	вкачивающий
вкачивающийся	вкачиваться	вкачивающийся
вкачивающим	вкачивать	вкачивающий
вкачивающими	вкачивать	вкачивающий
вкачивающимися	вкачиваться	вкачивающийся
вкачивающимся	вкачиваться	вкачивающийся
вкачивающих	вкачивать	вкачивающий
вкачивающихся	вкачиваться	вкачивающийся
вкачивающую	вкачивать	вкачивающий
вкачивающуюся	вкачиваться	вкачивающийся
вкачивая	вкачивать	вкачивая
вкачиваясь	вкачиваться	вкачиваясь
вкидав	вкидать	вкидав
вкидавшая	вкидать	вкидавший
вкидавшего	вкидать	вкидавший
вкидавшее	вкидать	вкидавший
вкидавшей	вкидать	вкидавший
вкидавшем	вкидать	вкидавший
вкидавшему	вкидать	вкидавший
вкидавшею	вкидать	вкидавший
вкидавшие	вкидать	вкидавший
вкидавший	вкидать	вкидавший
вкидавшим	вкидать	вкидавший
вкидавшими	вкидать	вкидавший
вкидавших	вкидать	вкидавший
вкидавшую	вкидать	вкидавший
вкидывавшаяся	вкидываться	вкидывавшийся
вкидывавшегося	вкидываться	вкидывавшийся
вкидывавшееся	вкидываться	вкидывавшийся
вкидывавшейся	вкидываться	вкидывавшийся
вкидывавшемся	вкидываться	вкидывавшийся
вкидывавшемуся	вкидываться	вкидывавшийся
вкидывавшеюся	вкидываться	вкидывавшийся
вкидывавшиеся	вкидываться	вкидывавшийся
вкидывавшийся	вкидываться	вкидывавшийся
вкидывавшимися	вкидываться	вкидывавшийся
вкидывавшимся	вкидываться	вкидывавшийся
вкидывавшихся	вкидываться	вкидывавшийся
вкидывавшуюся	вкидываться	вкидывавшийся
вкидывании	вкидывания	вкидывание
вкидываний	вкидывания	вкидывание
вкидыванию	вкидывания	вкидывание
вкидывания	вкидывания	вкидывание
вкидываниям	вкидывания	вкидывание
вкидываниями	вкидывания	вкидывание
вкидываниях	вкидывания	вкидывание
вкидывающаяся	вкидываться	вкидывающийся
вкидывающегося	вкидываться	вкидывающийся
вкидывающееся	вкидываться	вкидывающийся
вкидывающейся	вкидываться	вкидывающийся
вкидывающемся	вкидываться	вкидывающийся
вкидывающемуся	вкидываться	вкидывающийся
вкидывающеюся	вкидываться	вкидывающийся
вкидывающиеся	вкидываться	вкидывающийся
вкидывающийся	вкидываться	вкидывающийся
вкидывающимися	вкидываться	вкидывающийся
вкидывающимся	вкидываться	вкидывающийся
вкидывающихся	вкидываться	вкидывающийся
вкидывающуюся	вкидываться	вкидывающийся
вкидывая	вкидывать	вкидывая
вкидываясь	вкидываться	вкидываясь
вкинув	вкинуть	вкинув
вкладочно	вкладочный	вкладочно
вкладывавшая	вкладывать	вкладывавший
вкладывавшаяся	вкладываться	вкладывавшийся
вкладывавшего	вкладывать	вкладывавший
вкладывавшегося	вкладываться	вкладывавшийся
вкладывавшее	вкладывать	вкладывавший
вкладывавшееся	вкладываться	вкладывавшийся
вкладывавшей	вкладывать	вкладывавший
вкладывавшейся	вкладываться	вкладывавшийся
вкладывавшем	вкладывать	вкладывавший
вкладывавшемся	вкладываться	вкладывавшийся
вкладывавшему	вкладывать	вкладывавший
вкладывавшемуся	вкладываться	вкладывавшийся
вкладывавшею	вкладывать	вкладывавший
вкладывавшеюся	вкладываться	вкладывавшийся
вкладывавшие	вкладывать	вкладывавший
вкладывавшиеся	вкладываться	вкладывавшийся
вкладывавший	вкладывать	вкладывавший
вкладывавшийся	вкладываться	вкладывавшийся
вкладывавшим	вкладывать	вкладывавший
вкладывавшими	вкладывать	вкладывавший
вкладывавшимися	вкладываться	вкладывавшийся
вкладывавшимся	вкладываться	вкладывавшийся
вкладывавших	вкладывать	вкладывавший
вкладывавшихся	вкладываться	вкладывавшийся
вкладывавшую	вкладывать	вкладывавший
вкладывавшуюся	вкладываться	вкладывавшийся
вкладываем	вкладывать	вкладываемый
вкладываема	вкладывать	вкладываемый
вкладываемая	вкладывать	вкладываемый
вкладываемо	вкладывать	вкладываемый
вкладываемого	вкладывать	вкладываемый
вкладываемое	вкладывать	вкладываемый
вкладываемой	вкладывать	вкладываемый
вкладываемом	вкладывать	вкладываемый
вкладываемому	вкладывать	вкладываемый
вкладываемою	вкладывать	вкладываемый
вкладываемую	вкладывать	вкладываемый
вкладываемы	вкладывать	вкладываемый
вкладываемые	вкладывать	вкладываемый
вкладываемый	вкладывать	вкладываемый
вкладываемым	вкладывать	вкладываемый
вкладываемыми	вкладывать	вкладываемый
вкладываемых	вкладывать	вкладываемый
вкладывающая	вкладывать	вкладывающий
вкладывающаяся	вкладываться	вкладывающийся
вкладывающего	вкладывать	вкладывающий
вкладывающегося	вкладываться	вкладывающийся
вкладывающее	вкладывать	вкладывающий
вкладывающееся	вкладываться	вкладывающийся
вкладывающей	вкладывать	вкладывающий
вкладывающейся	вкладываться	вкладывающийся
вкладывающем	вкладывать	вкладывающий
вкладывающемся	вкладываться	вкладывающийся
вкладывающему	вкладывать	вкладывающий
вкладывающемуся	вкладываться	вкладывающийся
вкладывающею	вкладывать	вкладывающий
вкладывающеюся	вкладываться	вкладывающийся
вкладывающие	вкладывать	вкладывающий
вкладывающиеся	вкладываться	вкладывающийся
вкладывающий	вкладывать	вкладывающий
вкладывающийся	вкладываться	вкладывающийся
вкладывающим	вкладывать	вкладывающий
вкладывающими	вкладывать	вкладывающий
вкладывающимися	вкладываться	вкладывающийся
вкладывающимся	вкладываться	вкладывающийся
вкладывающих	вкладывать	вкладывающий
вкладывающихся	вкладываться	вкладывающийся
вкладывающую	вкладывать	вкладывающий
вкладывающуюся	вкладываться	вкладывающийся
вкладывая	вкладывать	вкладывая
вкладываясь	вкладываться	вкладываясь
вклеен	вклеить	вклеенный
вклеена	вклеить	вклеенный
вклеенная	вклеить	вклеенный
вклеенного	вклеить	вклеенный
вклеенное	вклеить	вклеенный
вклеенной	вклеить	вклеенный
вклеенном	вклеить	вклеенный
вклеенному	вклеить	вклеенный
вклеенною	вклеить	вклеенный
вклеенную	вклеить	вклеенный
вклеенные	вклеить	вклеенный
вклеенный	вклеить	вклеенный
вклеенным	вклеить	вклеенный
вклеенными	вклеить	вклеенный
вклеенных	вклеить	вклеенный
вклеено	вклеить	вклеенный
вклеены	вклеить	вклеенный
вклеив	вклеить	вклеив
вклеивающая	вклеивать	вклеивающий
вклеивающаяся	вклеиваться	вклеивающийся
вклеивающего	вклеивать	вклеивающий
вклеивающегося	вклеиваться	вклеивающийся
вклеивающее	вклеивать	вклеивающий
вклеивающееся	вклеиваться	вклеивающийся
вклеивающей	вклеивать	вклеивающий
вклеивающейся	вклеиваться	вклеивающийся
вклеивающем	вклеивать	вклеивающий
вклеивающемся	вклеиваться	вклеивающийся
вклеивающему	вклеивать	вклеивающий
вклеивающемуся	вклеиваться	вклеивающийся
вклеивающею	вклеивать	вклеивающий
вклеивающеюся	вклеиваться	вклеивающийся
вклеивающие	вклеивать	вклеивающий
вклеивающиеся	вклеиваться	вклеивающийся
вклеивающий	вклеивать	вклеивающий
вклеивающийся	вклеиваться	вклеивающийся
вклеивающим	вклеивать	вклеивающий
вклеивающими	вклеивать	вклеивающий
вклеивающимися	вклеиваться	вклеивающийся
вклеивающимся	вклеиваться	вклеивающийся
вклеивающих	вклеивать	вклеивающий
вклеивающихся	вклеиваться	вклеивающийся
вклеивающую	вклеивать	вклеивающий
вклеивающуюся	вклеиваться	вклеивающийся
вклеивая	вклеивать	вклеивая
вклеиваясь	вклеиваться	вклеиваясь
вклеившая	вклеить	вклеивший
вклеившаяся	вклеиться	вклеившийся
вклеившего	вклеить	вклеивший
вклеившегося	вклеиться	вклеившийся
вклеившее	вклеить	вклеивший
вклеившееся	вклеиться	вклеившийся
вклеившей	вклеить	вклеивший
вклеившейся	вклеиться	вклеившийся
вклеившем	вклеить	вклеивший
вклеившемся	вклеиться	вклеившийся
вклеившему	вклеить	вклеивший
вклеившемуся	вклеиться	вклеившийся
вклеившею	вклеить	вклеивший
вклеившеюся	вклеиться	вклеившийся
вклеившие	вклеить	вклеивший
вклеившиеся	вклеиться	вклеившийся
вклеивший	вклеить	вклеивший
вклеившийся	вклеиться	вклеившийся
вклеившим	вклеить	вклеивший
вклеившими	вклеить	вклеивший
вклеившимися	вклеиться	вклеившийся
вклеившимся	вклеиться	вклеившийся
вклеившись	вклеиться	вклеившись
вклеивших	вклеить	вклеивший
вклеившихся	вклеиться	вклеившийся
вклеившую	вклеить	вклеивший
вклеившуюся	вклеиться	вклеившийся
вклепав	вклепать	вклепав
вклепан	вклепать	вклепанный
вклепана	вклепать	вклепанный
вклепанная	вклепать	вклепанный
вклепанного	вклепать	вклепанный
вклепанное	вклепать	вклепанный
вклепанной	вклепать	вклепанный
вклепанном	вклепать	вклепанный
вклепанному	вклепать	вклепанный
вклепанною	вклепать	вклепанный
вклепанную	вклепать	вклепанный
вклепанные	вклепать	вклепанный
вклепанный	вклепать	вклепанный
вклепанным	вклепать	вклепанный
вклепанными	вклепать	вклепанный
вклепанных	вклепать	вклепанный
вклепано	вклепать	вклепанный
вклепаны	вклепать	вклепанный
вклепка	вклёпка	вклепка
вклепкам	вклёпка	вклепка
вклепками	вклёпка	вклепка
вклепках	вклёпка	вклепка
вклепке	вклёпка	вклепка
вклепки	вклёпка	вклепка
вклепкой	вклёпка	вклепка
вклепкою	вклёпка	вклепка
вклепку	вклёпка	вклепка
вклепок	вклёпка	вклепка
вклепываем	вклёпывать	вклепывать
вклепываемся	вклёпываться	вклепываться
вклепывает	вклёпывать	вклепывать
вклепываете	вклёпывать	вклепывать
вклепываетесь	вклёпываться	вклепываться
вклепывается	вклёпываться	вклепываться
вклепываешь	вклёпывать	вклепывать
вклепываешься	вклёпываться	вклепываться
вклепывай	вклёпывать	вклепывать
вклепывайся	вклёпываться	вклепываться
вклепывайте	вклёпывать	вклепывать
вклепывайтесь	вклёпываться	вклепываться
вклепывал	вклёпывать	вклепывать
вклепывала	вклёпывать	вклепывать
вклепывалась	вклёпываться	вклепываться
вклепывали	вклёпывать	вклепывать
вклепывались	вклёпываться	вклепываться
вклепывало	вклёпывать	вклепывать
вклепывалось	вклёпываться	вклепываться
вклепывался	вклёпываться	вклепываться
вклепывать	вклёпывать	вклепывать
вклепываться	вклёпываться	вклепываться
вклепываю	вклёпывать	вклепывать
вклепываюсь	вклёпываться	вклепываться
вклепывают	вклёпывать	вклепывать
вклепываются	вклёпываться	вклепываться
вклепывая	вклёпывать	вклепывая
вклепываясь	вклёпываться	вклепываясь
вклещившись	вклещиться	вклещившись
вклещились	вклещилися	вклещиться
вклещимся	вклещийся	вклещиться
вклещись	вклестаться	вклещиться
вклещусь	вклеститься	вклещиться
вклинен	вклинить	вклиненный
вклинена	вклинить	вклиненный
вклиненная	вклинить	вклиненный
вклиненного	вклинить	вклиненный
вклиненное	вклинить	вклиненный
вклиненной	вклинить	вклиненный
вклиненном	вклинить	вклиненный
вклиненному	вклинить	вклиненный
вклиненною	вклинить	вклиненный
вклиненную	вклинить	вклиненный
вклиненные	вклинить	вклиненный
вклиненный	вклинить	вклиненный
вклиненным	вклинить	вклиненный
вклиненными	вклинить	вклиненный
вклиненных	вклинить	вклиненный
вклинено	вклинить	вклиненный
вклинены	вклинить	вклиненный
вклинив	вклинить	вклинив
вклинивавшаяся	вклиниваться	вклинивавшийся
вклинивавшегося	вклиниваться	вклинивавшийся
вклинивавшееся	вклиниваться	вклинивавшийся
вклинивавшейся	вклиниваться	вклинивавшийся
вклинивавшемся	вклиниваться	вклинивавшийся
вклинивавшемуся	вклиниваться	вклинивавшийся
вклинивавшеюся	вклиниваться	вклинивавшийся
вклинивавшиеся	вклиниваться	вклинивавшийся
вклинивавшийся	вклиниваться	вклинивавшийся
вклинивавшимися	вклиниваться	вклинивавшийся
вклинивавшимся	вклиниваться	вклинивавшийся
вклинивавшихся	вклиниваться	вклинивавшийся
вклинивавшуюся	вклиниваться	вклинивавшийся
вклинивающаяся	вклиниваться	вклинивающийся
вклинивающегося	вклиниваться	вклинивающийся
вклинивающееся	вклиниваться	вклинивающийся
вклинивающейся	вклиниваться	вклинивающийся
вклинивающемся	вклиниваться	вклинивающийся
вклинивающемуся	вклиниваться	вклинивающийся
вклинивающеюся	вклиниваться	вклинивающийся
вклинивающиеся	вклиниваться	вклинивающийся
вклинивающийся	вклиниваться	вклинивающийся
вклинивающимися	вклиниваться	вклинивающийся
вклинивающимся	вклиниваться	вклинивающийся
вклинивающихся	вклиниваться	вклинивающийся
вклинивающуюся	вклиниваться	вклинивающийся
вклинивая	вклинивать	вклинивая
вклиниваясь	вклиниваться	вклиниваясь
вклинившая	вклинить	вклинивший
вклинившаяся	вклиниться	вклинившийся
вклинившего	вклинить	вклинивший
вклинившегося	вклиниться	вклинившийся
вклинившее	вклинить	вклинивший
вклинившееся	вклиниться	вклинившийся
вклинившей	вклинить	вклинивший
вклинившейся	вклиниться	вклинившийся
вклинившем	вклинить	вклинивший
вклинившемся	вклиниться	вклинившийся
вклинившему	вклинить	вклинивший
вклинившемуся	вклиниться	вклинившийся
вклинившею	вклинить	вклинивший
вклинившеюся	вклиниться	вклинившийся
вклинившие	вклинить	вклинивший
вклинившиеся	вклиниться	вклинившийся
вклинивший	вклинить	вклинивший
вклинившийся	вклиниться	вклинившийся
вклинившим	вклинить	вклинивший
вклинившими	вклинить	вклинивший
вклинившимися	вклиниться	вклинившийся
вклинившимся	вклиниться	вклинившийся
вклинившись	вклиниться	вклинившись
вклинивших	вклинить	вклинивший
вклинившихся	вклиниться	вклинившийся
вклинившую	вклинить	вклинивший
вклинившуюся	вклиниться	вклинившийся
включавшая	включать	включавший
включавшаяся	включаться	включавшийся
включавшего	включать	включавший
включавшегося	включаться	включавшийся
включавшее	включать	включавший
включавшееся	включаться	включавшийся
включавшей	включать	включавший
включавшейся	включаться	включавшийся
включавшем	включать	включавший
включавшемся	включаться	включавшийся
включавшему	включать	включавший
включавшемуся	включаться	включавшийся
включавшею	включать	включавший
включавшеюся	включаться	включавшийся
включавшие	включать	включавший
включавшиеся	включаться	включавшийся
включавший	включать	включавший
включавшийся	включаться	включавшийся
включавшим	включать	включавший
включавшими	включать	включавший
включавшимися	включаться	включавшийся
включавшимся	включаться	включавшийся
включавших	включать	включавший
включавшихся	включаться	включавшийся
включавшую	включать	включавший
включавшуюся	включаться	включавшийся
включаем	включать	включаемый
включаема	включать	включаемый
включаемая	включать	включаемый
включаемо	включать	включаемый
включаемого	включать	включаемый
включаемое	включать	включаемый
включаемой	включать	включаемый
включаемом	включать	включаемый
включаемому	включать	включаемый
включаемою	включать	включаемый
включаемую	включать	включаемый
включаемы	включать	включаемый
включаемые	включать	включаемый
включаемый	включать	включаемый
включаемым	включать	включаемый
включаемыми	включать	включаемый
включаемых	включать	включаемый
включающая	включать	включающий
включающаяся	включаться	включающийся
включающего	включать	включающий
включающегося	включаться	включающийся
включающее	включать	включающий
включающееся	включаться	включающийся
включающей	включать	включающий
включающейся	включаться	включающийся
включающем	включать	включающий
включающемся	включаться	включающийся
включающему	включать	включающий
включающемуся	включаться	включающийся
включающею	включать	включающий
включающеюся	включаться	включающийся
включающие	включать	включающий
включающиеся	включаться	включающийся
включающий	включать	включающий
включающийся	включаться	включающийся
включающим	включать	включающий
включающими	включать	включающий
включающимися	включаться	включающийся
включающимся	включаться	включающийся
включающих	включать	включающий
включающихся	включаться	включающийся
включающую	включать	включающий
включающуюся	включаться	включающийся
включаясь	включаться	включаясь
включен	включить	включенный
включена	включить	включенный
включенная	включить	включенный
включенного	включить	включенный
включенное	включить	включенный
включенной	включить	включенный
включенном	включить	включенный
включенному	включить	включенный
включенности	включённость	включенность
включенность	включённость	включенность
включенностью	включённость	включенность
включенною	включить	включенный
включенную	включить	включенный
включенные	включить	включенный
включенный	включить	включенный
включенным	включить	включенный
включенными	включить	включенный
включенных	включить	включенный
включено	включить	включенный
включены	включить	включенный
включив	включить	включив
включившая	включить	включивший
включившаяся	включиться	включившийся
включившего	включить	включивший
включившегося	включиться	включившийся
включившее	включить	включивший
включившееся	включиться	включившийся
включившей	включить	включивший
включившейся	включиться	включившийся
включившем	включить	включивший
включившемся	включиться	включившийся
включившему	включить	включивший
включившемуся	включиться	включившийся
включившею	включить	включивший
включившеюся	включиться	включившийся
включившие	включить	включивший
включившиеся	включиться	включившийся
включивший	включить	включивший
включившийся	включиться	включившийся
включившим	включить	включивший
включившими	включить	включивший
включившимися	включиться	включившийся
включившимся	включиться	включившийся
включившись	включиться	включившись
включивших	включить	включивший
включившихся	включиться	включившийся
включившую	включить	включивший
включившуюся	включиться	включившийся
вковав	вковать	вковав
вковывании	вковывания	вковывание
вковываний	вковывания	вковывание
вковыванию	вковывания	вковывание
вковывания	вковывания	вковывание
вковываниям	вковывания	вковывание
вковываниями	вковывания	вковывание
вковываниях	вковывания	вковывание
вковывая	вковывать	вковывая
вколачивавшая	вколачивать	вколачивавший
вколачивавшаяся	вколачиваться	вколачивавшийся
вколачивавшего	вколачивать	вколачивавший
вколачивавшегося	вколачиваться	вколачивавшийся
вколачивавшее	вколачивать	вколачивавший
вколачивавшееся	вколачиваться	вколачивавшийся
вколачивавшей	вколачивать	вколачивавший
вколачивавшейся	вколачиваться	вколачивавшийся
вколачивавшем	вколачивать	вколачивавший
вколачивавшемся	вколачиваться	вколачивавшийся
вколачивавшему	вколачивать	вколачивавший
вколачивавшемуся	вколачиваться	вколачивавшийся
вколачивавшею	вколачивать	вколачивавший
вколачивавшеюся	вколачиваться	вколачивавшийся
вколачивавшие	вколачивать	вколачивавший
вколачивавшиеся	вколачиваться	вколачивавшийся
вколачивавший	вколачивать	вколачивавший
вколачивавшийся	вколачиваться	вколачивавшийся
вколачивавшим	вколачивать	вколачивавший
вколачивавшими	вколачивать	вколачивавший
вколачивавшимися	вколачиваться	вколачивавшийся
вколачивавшимся	вколачиваться	вколачивавшийся
вколачивавших	вколачивать	вколачивавший
вколачивавшихся	вколачиваться	вколачивавшийся
вколачивавшую	вколачивать	вколачивавший
вколачивавшуюся	вколачиваться	вколачивавшийся
вколачиваем	вколачивать	вколачиваемый
вколачиваема	вколачивать	вколачиваемый
вколачиваемая	вколачивать	вколачиваемый
вколачиваемо	вколачивать	вколачиваемый
вколачиваемого	вколачивать	вколачиваемый
вколачиваемое	вколачивать	вколачиваемый
вколачиваемой	вколачивать	вколачиваемый
вколачиваемом	вколачивать	вколачиваемый
вколачиваемому	вколачивать	вколачиваемый
вколачиваемою	вколачивать	вколачиваемый
вколачиваемую	вколачивать	вколачиваемый
вколачиваемы	вколачивать	вколачиваемый
вколачиваемые	вколачивать	вколачиваемый
вколачиваемый	вколачивать	вколачиваемый
вколачиваемым	вколачивать	вколачиваемый
вколачиваемыми	вколачивать	вколачиваемый
вколачиваемых	вколачивать	вколачиваемый
вколачивающая	вколачивать	вколачивающий
вколачивающаяся	вколачиваться	вколачивающийся
вколачивающего	вколачивать	вколачивающий
вколачивающегося	вколачиваться	вколачивающийся
вколачивающее	вколачивать	вколачивающий
вколачивающееся	вколачиваться	вколачивающийся
вколачивающей	вколачивать	вколачивающий
вколачивающейся	вколачиваться	вколачивающийся
вколачивающем	вколачивать	вколачивающий
вколачивающемся	вколачиваться	вколачивающийся
вколачивающему	вколачивать	вколачивающий
вколачивающемуся	вколачиваться	вколачивающийся
вколачивающею	вколачивать	вколачивающий
вколачивающеюся	вколачиваться	вколачивающийся
вколачивающие	вколачивать	вколачивающий
вколачивающиеся	вколачиваться	вколачивающийся
вколачивающий	вколачивать	вколачивающий
вколачивающийся	вколачиваться	вколачивающийся
вколачивающим	вколачивать	вколачивающий
вколачивающими	вколачивать	вколачивающий
вколачивающимися	вколачиваться	вколачивающийся
вколачивающимся	вколачиваться	вколачивающийся
вколачивающих	вколачивать	вколачивающий
вколачивающихся	вколачиваться	вколачивающийся
вколачивающую	вколачивать	вколачивающий
вколачивающуюся	вколачиваться	вколачивающийся
вколачивая	вколачивать	вколачивая
вколачиваясь	вколачиваться	вколачиваясь
вколов	вколоть	вколов
вколовшая	вколоть	вколовший
вколовшего	вколоть	вколовший
вколовшее	вколоть	вколовший
вколовшей	вколоть	вколовший
вколовшем	вколоть	вколовший
вколовшему	вколоть	вколовший
вколовшею	вколоть	вколовший
вколовшие	вколоть	вколовший
вколовший	вколоть	вколовший
вколовшим	вколоть	вколовший
вколовшими	вколоть	вколовший
вколовшись	вколоться	вколовшись
вколовших	вколоть	вколовший
вколовшую	вколоть	вколовший
вколот	вколоть	вколотый
вколота	вколоть	вколотый
вколотая	вколоть	вколотый
вколотив	вколотить	вколотив
вколотившая	вколотить	вколотивший
вколотившего	вколотить	вколотивший
вколотившее	вколотить	вколотивший
вколотившей	вколотить	вколотивший
вколотившем	вколотить	вколотивший
вколотившему	вколотить	вколотивший
вколотившею	вколотить	вколотивший
вколотившие	вколотить	вколотивший
вколотивший	вколотить	вколотивший
вколотившим	вколотить	вколотивший
вколотившими	вколотить	вколотивший
вколотившись	вколотиться	вколотившись
вколотивших	вколотить	вколотивший
вколотившую	вколотить	вколотивший
вколото	вколоть	вколотый
вколотого	вколоть	вколотый
вколотое	вколоть	вколотый
вколотой	вколоть	вколотый
вколотом	вколоть	вколотый
вколотому	вколоть	вколотый
вколотою	вколоть	вколотый
вколотую	вколоть	вколотый
вколоты	вколоть	вколотый
вколотые	вколоть	вколотый
вколотый	вколоть	вколотый
вколотым	вколоть	вколотый
вколотыми	вколоть	вколотый
вколотых	вколоть	вколотый
вколочен	вколотить	вколоченный
вколочена	вколотить	вколоченный
вколоченная	вколотить	вколоченный
вколоченного	вколотить	вколоченный
вколоченное	вколотить	вколоченный
вколоченной	вколотить	вколоченный
вколоченном	вколотить	вколоченный
вколоченному	вколотить	вколоченный
вколоченною	вколотить	вколоченный
вколоченную	вколотить	вколоченный
вколоченные	вколотить	вколоченный
вколоченный	вколотить	вколоченный
вколоченным	вколотить	вколоченный
вколоченными	вколотить	вколоченный
вколоченных	вколотить	вколоченный
вколочено	вколотить	вколоченный
вколочены	вколотить	вколоченный
вкоп	вкопа	вкоп
вкопа	вкопа	вкоп
вкопав	вкопать	вкопав
вкопавшая	вкопать	вкопавший
вкопавшаяся	вкопаться	вкопавшийся
вкопавшего	вкопать	вкопавший
вкопавшегося	вкопаться	вкопавшийся
вкопавшее	вкопать	вкопавший
